11111111111
10000000001
1111P000X01
10X00000XC1
10000XE1111
11111111111
