1111111
10000E1
10C1001
10011P1
1111111
