11111111
100000P1
10000001
1X0C0001
11110001
11111101
1E0000C1
11111111
