11111
1P0P1
10001
1C0E1
11111
