1111111111111111111111111111
1CCCCCCCCCCCCCCCCCCCCCCCCCC1
1C1111111111111111111C1111C1
1C11111111CCCCCCCCCCCC111CC1
1C11111111E111111111111111C1
1C1111111111111111111CCCCCC1
1CCCCCCC111111111111CC111111
111111PCCCCCCCCCCCCCC1111111
1111111111111111111111111111
