11111111111
10000000001
11110000001
100000000C1
100000E1111
11111111111
