11111111111
10000000001
1111P000001
100000000C1
10000001111
11111111111
